#SampleID	BarcodeSequence	LinkerPrimerSequence	Description
pwer1	TACCTTGGGTGATCCCTTGTCTCC	TACCTTGGGTGATCCCTTGTCTCC	
pwer2	TACCTTGGGTGAACGAGACTGATT	TACCTTGGGTGAACGAGACTGATT	
pwer3	TACCTTGGGTGAACCGGTATGTAC	TACCTTGGGTGAACCGGTATGTAC	
pwer4	TACCTTGGGTGATGCATACACTGG	TACCTTGGGTGATGCATACACTGG	
pwer5	TACCTTGGGTGATGGTCAACGATA	TACCTTGGGTGATGGTCAACGATA	
pwer6	TACCTTGGGTGAATCGCACAGTAA	TACCTTGGGTGAATCGCACAGTAA	
pwer7	TACCTTGGGTGAGTCGTGTAGCCT	TACCTTGGGTGAGTCGTGTAGCCT	
pwer8	TACCTTGGGTGATACAGCGCATAC	TACCTTGGGTGATACAGCGCATAC	
pwer9	TACCTTGGGTGAATCCTTTGGTTC	TACCTTGGGTGAATCCTTTGGTTC	
pwer10	TACCTTGGGTGAAGTCGAACGAGG	TACCTTGGGTGAAGTCGAACGAGG	
pwer11	TACCTTGGGTGAACCAGTGACTCA	TACCTTGGGTGAACCAGTGACTCA	
pwer12	TACCTTGGGTGACCAATACGCCTG	TACCTTGGGTGACCAATACGCCTG	
pwer13	TACCTTGGGTGAGCAACACCATCC	TACCTTGGGTGAGCAACACCATCC	
pwer14	TACCTTGGGTGAAGTCGTGCACAT	TACCTTGGGTGAAGTCGTGCACAT	
pwer15	TACCTTGGGTGAAGTTACGAGCTA	TACCTTGGGTGAAGTTACGAGCTA	
pwer16	TACCTTGGGTGATTGCGTTAGCAG	TACCTTGGGTGATTGCGTTAGCAG	
pwer17	TACCTTGGGTGATACGAGCCCTAA	TACCTTGGGTGATACGAGCCCTAA	
pwer18	TACCTTGGGTGATGTCGCAAATAG	TACCTTGGGTGATGTCGCAAATAG	
pwer19	TACCTTGGGTGAACAATAGACACC	TACCTTGGGTGAACAATAGACACC	
pwer20	TACCTTGGGTGATCTCTACCACTC	TACCTTGGGTGATCTCTACCACTC	
pwer21	TACCTTGGGTGACGATCGAACACT	TACCTTGGGTGACGATCGAACACT	
pwer22	TACCTTGGGTGAATTGCAAGCAAC	TACCTTGGGTGAATTGCAAGCAAC	
pwer23	TACCTTGGGTGAAGCGCTCACATC	TACCTTGGGTGAAGCGCTCACATC	
pwer24	TACCTTGGGTGATCGACCAAACAC	TACCTTGGGTGATCGACCAAACAC	
pwer25	TACCTTGGGTGATGTGTTACTCCT	TACCTTGGGTGATGTGTTACTCCT	
pwer26	TACCTTGGGTGATGCACAGTCGCT	TACCTTGGGTGATGCACAGTCGCT	
pwer27	TACCTTGGGTGATTCTAGAGTGCG	TACCTTGGGTGATTCTAGAGTGCG	
pwer28	TACCTTGGGTGAACACCTGCGATC	TACCTTGGGTGAACACCTGCGATC	
pwer29	TACCTTGGGTGAATTCCTCTCCAC	TACCTTGGGTGAATTCCTCTCCAC	
pwer30	TACCTTGGGTGACATCGACGAGTT	TACCTTGGGTGACATCGACGAGTT	
pwer31	TACCTTGGGTGACACCACAGAATC	TACCTTGGGTGACACCACAGAATC	
pwer32	TACCTTGGGTGAGGTCTTAGCACC	TACCTTGGGTGAGGTCTTAGCACC	
pwer33	TACCTTGGGTGATATCGCGCGATA	TACCTTGGGTGATATCGCGCGATA	
pwer34	TACCTTGGGTGACTCTACGAACAG	TACCTTGGGTGACTCTACGAACAG	
pwer35	TACCTTGGGTGACTCCTCCCTTAC	TACCTTGGGTGACTCCTCCCTTAC	
pwer36	TACCTTGGGTGACGTGTTATGTGG	TACCTTGGGTGACGTGTTATGTGG	
pwer37	TACCTTGGGTGAATTAGCAGCGTA	TACCTTGGGTGAATTAGCAGCGTA	
pwer38	TACCTTGGGTGACAAGTTTCCGCG	TACCTTGGGTGACAAGTTTCCGCG	
pwer39	TACCTTGGGTGACCTTGTTCACCT	TACCTTGGGTGACCTTGTTCACCT	
pwer40	TACCTTGGGTGAAACCAGCAGATT	TACCTTGGGTGAAACCAGCAGATT	
pwer41	TACCTTGGGTGACTAGAGCTCCCA	TACCTTGGGTGACTAGAGCTCCCA	
pwer42	TACCTTGGGTGACACGCAGTCTAC	TACCTTGGGTGACACGCAGTCTAC	
pwer43	TACCTTGGGTGAACAAACATGGTC	TACCTTGGGTGAACAAACATGGTC	
pwer44	TACCTTGGGTGATCGAAACATGCA	TACCTTGGGTGATCGAAACATGCA	
pwer45	TACCTTGGGTGATTCCCACCCATT	TACCTTGGGTGATTCCCACCCATT	
pwer46	TACCTTGGGTGAAGCAGAACATCT	TACCTTGGGTGAAGCAGAACATCT	
pwer47	TACCTTGGGTGAGAAACATCCCAC	TACCTTGGGTGAGAAACATCCCAC	
pwer48	TACCTTGGGTGACTGTCAGTGACC	TACCTTGGGTGACTGTCAGTGACC	
pwer49	TACCTTGGGTGACGGATCTAGTGT	TACCTTGGGTGACGGATCTAGTGT	
pwer50	TACCTTGGGTGATTCTCCATCACA	TACCTTGGGTGATTCTCCATCACA	
pwer51	TACCTTGGGTGAATTTAGGACGAC	TACCTTGGGTGAATTTAGGACGAC	
pwer52	TACCTTGGGTGAGGTTTAACACGC	TACCTTGGGTGAGGTTTAACACGC	
pwer53	TACCTTGGGTGAAGACAGTAGGAG	TACCTTGGGTGAAGACAGTAGGAG	
pwer54	TACCTTGGGTGAGCAGATTTCCAG	TACCTTGGGTGAGCAGATTTCCAG	
pwer55	TACCTTGGGTGAAGATGATCAGTC	TACCTTGGGTGAAGATGATCAGTC	
pwer56	TACCTTGGGTGATATCACCGGCAC	TACCTTGGGTGATATCACCGGCAC	
pwer57	TACCTTGGGTGACCAGATATAGCA	TACCTTGGGTGACCAGATATAGCA	
pwer58	CTCCATCAACAATCCCTTGTCTCC	CTCCATCAACAATCCCTTGTCTCC	
pwer59	CTCCATCAACAAACGAGACTGATT	CTCCATCAACAAACGAGACTGATT	
pwer60	CTCCATCAACAAACCGGTATGTAC	CTCCATCAACAAACCGGTATGTAC	
pwer61	CTCCATCAACAATGCATACACTGG	CTCCATCAACAATGCATACACTGG	
pwer62	CTCCATCAACAATGGTCAACGATA	CTCCATCAACAATGGTCAACGATA	
pwer63	CTCCATCAACAAATCGCACAGTAA	CTCCATCAACAAATCGCACAGTAA	
pwer64	CTCCATCAACAAGTCGTGTAGCCT	CTCCATCAACAAGTCGTGTAGCCT	
pwer65	CTCCATCAACAATACAGCGCATAC	CTCCATCAACAATACAGCGCATAC	
pwer66	CTCCATCAACAAATCCTTTGGTTC	CTCCATCAACAAATCCTTTGGTTC	
pwer67	CTCCATCAACAAAGTCGAACGAGG	CTCCATCAACAAAGTCGAACGAGG	
pwer68	CTCCATCAACAAACCAGTGACTCA	CTCCATCAACAAACCAGTGACTCA	
pwer69	CTCCATCAACAACCAATACGCCTG	CTCCATCAACAACCAATACGCCTG	
pwer70	CTCCATCAACAAGCAACACCATCC	CTCCATCAACAAGCAACACCATCC	
pwer71	CTCCATCAACAAAGTCGTGCACAT	CTCCATCAACAAAGTCGTGCACAT	
pwer72	CTCCATCAACAAAGTTACGAGCTA	CTCCATCAACAAAGTTACGAGCTA	
pwer73	CTCCATCAACAATTGCGTTAGCAG	CTCCATCAACAATTGCGTTAGCAG	
pwer74	CTCCATCAACAATACGAGCCCTAA	CTCCATCAACAATACGAGCCCTAA	
pwer75	CTCCATCAACAATGTCGCAAATAG	CTCCATCAACAATGTCGCAAATAG	
pwer76	CTCCATCAACAAACAATAGACACC	CTCCATCAACAAACAATAGACACC	
pwer77	CTCCATCAACAATCTCTACCACTC	CTCCATCAACAATCTCTACCACTC	
pwer78	CTCCATCAACAACGATCGAACACT	CTCCATCAACAACGATCGAACACT	
pwer79	CTCCATCAACAAATTGCAAGCAAC	CTCCATCAACAAATTGCAAGCAAC	
pwer80	CTCCATCAACAAAGCGCTCACATC	CTCCATCAACAAAGCGCTCACATC	
pwer81	CTCCATCAACAATCGACCAAACAC	CTCCATCAACAATCGACCAAACAC	
pwer82	CTCCATCAACAATGTGTTACTCCT	CTCCATCAACAATGTGTTACTCCT	
pwer83	CTCCATCAACAATGCACAGTCGCT	CTCCATCAACAATGCACAGTCGCT	
pwer84	CTCCATCAACAATTCTAGAGTGCG	CTCCATCAACAATTCTAGAGTGCG	
pwer85	CTCCATCAACAAACACCTGCGATC	CTCCATCAACAAACACCTGCGATC	
pwer86	CTCCATCAACAAATTCCTCTCCAC	CTCCATCAACAAATTCCTCTCCAC	
pwer87	CTCCATCAACAACATCGACGAGTT	CTCCATCAACAACATCGACGAGTT	
pwer88	CTCCATCAACAACACCACAGAATC	CTCCATCAACAACACCACAGAATC	
pwer89	CTCCATCAACAAGGTCTTAGCACC	CTCCATCAACAAGGTCTTAGCACC	
pwer90	CTCCATCAACAATATCGCGCGATA	CTCCATCAACAATATCGCGCGATA	
pwer91	CTCCATCAACAACTCTACGAACAG	CTCCATCAACAACTCTACGAACAG	
pwer92	CTCCATCAACAACTCCTCCCTTAC	CTCCATCAACAACTCCTCCCTTAC	
pwer93	CTCCATCAACAACGTGTTATGTGG	CTCCATCAACAACGTGTTATGTGG	
pwer94	CTCCATCAACAAATTAGCAGCGTA	CTCCATCAACAAATTAGCAGCGTA	
pwer95	CTCCATCAACAACAAGTTTCCGCG	CTCCATCAACAACAAGTTTCCGCG	
pwer96	CTCCATCAACAACCTTGTTCACCT	CTCCATCAACAACCTTGTTCACCT	
pwer97	CTCCATCAACAAAACCAGCAGATT	CTCCATCAACAAAACCAGCAGATT	
pwer98	CTCCATCAACAACTAGAGCTCCCA	CTCCATCAACAACTAGAGCTCCCA	
pwer99	CTCCATCAACAACACGCAGTCTAC	CTCCATCAACAACACGCAGTCTAC	
pwer100	CTCCATCAACAAACAAACATGGTC	CTCCATCAACAAACAAACATGGTC	
pwer101	CTCCATCAACAATCGAAACATGCA	CTCCATCAACAATCGAAACATGCA	
pwer102	CTCCATCAACAATTCCCACCCATT	CTCCATCAACAATTCCCACCCATT	
pwer103	CTCCATCAACAAAGCAGAACATCT	CTCCATCAACAAAGCAGAACATCT	
pwer104	CTCCATCAACAAGAAACATCCCAC	CTCCATCAACAAGAAACATCCCAC	
pwer105	CTCCATCAACAACTGTCAGTGACC	CTCCATCAACAACTGTCAGTGACC	
pwer106	CTCCATCAACAACGGATCTAGTGT	CTCCATCAACAACGGATCTAGTGT	
pwer107	CTCCATCAACAATTCTCCATCACA	CTCCATCAACAATTCTCCATCACA	
pwer108	CTCCATCAACAAATTTAGGACGAC	CTCCATCAACAAATTTAGGACGAC	
pwer109	CTCCATCAACAAGGTTTAACACGC	CTCCATCAACAAGGTTTAACACGC	
pwer110	CTCCATCAACAAAGACAGTAGGAG	CTCCATCAACAAAGACAGTAGGAG	
pwer111	CTCCATCAACAAGCAGATTTCCAG	CTCCATCAACAAGCAGATTTCCAG	
pwer112	CTCCATCAACAAAGATGATCAGTC	CTCCATCAACAAAGATGATCAGTC	
pwer113	CTCCATCAACAATATCACCGGCAC	CTCCATCAACAATATCACCGGCAC	
pwer114	CTCCATCAACAACCAGATATAGCA	CTCCATCAACAACCAGATATAGCA	
pwer115	AGCGCAACATTCTCCCTTGTCTCC	AGCGCAACATTCTCCCTTGTCTCC	
pwer116	AGCGCAACATTCACGAGACTGATT	AGCGCAACATTCACGAGACTGATT	
pwer117	AGCGCAACATTCACCGGTATGTAC	AGCGCAACATTCACCGGTATGTAC	
pwer118	AGCGCAACATTCTGCATACACTGG	AGCGCAACATTCTGCATACACTGG	
pwer119	AGCGCAACATTCTGGTCAACGATA	AGCGCAACATTCTGGTCAACGATA	
pwer120	AGCGCAACATTCATCGCACAGTAA	AGCGCAACATTCATCGCACAGTAA	
pwer121	AGCGCAACATTCGTCGTGTAGCCT	AGCGCAACATTCGTCGTGTAGCCT	
pwer122	AGCGCAACATTCTACAGCGCATAC	AGCGCAACATTCTACAGCGCATAC	
pwer123	AGCGCAACATTCATCCTTTGGTTC	AGCGCAACATTCATCCTTTGGTTC	
pwer124	AGCGCAACATTCGGTCTCCTACAG	AGCGCAACATTCGGTCTCCTACAG	
pwer125	AGCGCAACATTCACCAGTGACTCA	AGCGCAACATTCACCAGTGACTCA	
pwer126	AGCGCAACATTCCCAATACGCCTG	AGCGCAACATTCCCAATACGCCTG	
pwer127	AGCGCAACATTCGCAACACCATCC	AGCGCAACATTCGCAACACCATCC	
pwer128	AGCGCAACATTCAGTCGTGCACAT	AGCGCAACATTCAGTCGTGCACAT	
pwer129	AGCGCAACATTCAGTTACGAGCTA	AGCGCAACATTCAGTTACGAGCTA	
pwer130	AGCGCAACATTCTTGCGTTAGCAG	AGCGCAACATTCTTGCGTTAGCAG	
pwer131	AGCGCAACATTCTACGAGCCCTAA	AGCGCAACATTCTACGAGCCCTAA	
pwer132	AGCGCAACATTCTGTCGCAAATAG	AGCGCAACATTCTGTCGCAAATAG	
pwer133	AGCGCAACATTCACAATAGACACC	AGCGCAACATTCACAATAGACACC	
pwer134	AGCGCAACATTCTCTCTACCACTC	AGCGCAACATTCTCTCTACCACTC	
pwer135	AGCGCAACATTCCGATCGAACACT	AGCGCAACATTCCGATCGAACACT	
pwer136	AGCGCAACATTCATTGCAAGCAAC	AGCGCAACATTCATTGCAAGCAAC	
pwer137	AGCGCAACATTCAGCGCTCACATC	AGCGCAACATTCAGCGCTCACATC	
pwer138	AGCGCAACATTCTCGACCAAACAC	AGCGCAACATTCTCGACCAAACAC	
pwer139	AGCGCAACATTCTGTGTTACTCCT	AGCGCAACATTCTGTGTTACTCCT	
pwer140	AGCGCAACATTCTGCACAGTCGCT	AGCGCAACATTCTGCACAGTCGCT	
pwer141	AGCGCAACATTCTTCTAGAGTGCG	AGCGCAACATTCTTCTAGAGTGCG	
pwer142	AGCGCAACATTCACACCTGCGATC	AGCGCAACATTCACACCTGCGATC	
pwer143	AGCGCAACATTCATTCCTCTCCAC	AGCGCAACATTCATTCCTCTCCAC	
pwer144	AGCGCAACATTCCATCGACGAGTT	AGCGCAACATTCCATCGACGAGTT	
pwer145	AGCGCAACATTCCACCACAGAATC	AGCGCAACATTCCACCACAGAATC	
pwer146	AGCGCAACATTCGGTCTTAGCACC	AGCGCAACATTCGGTCTTAGCACC	
pwer147	AGCGCAACATTCTATCGCGCGATA	AGCGCAACATTCTATCGCGCGATA	
pwer148	AGCGCAACATTCCTCTACGAACAG	AGCGCAACATTCCTCTACGAACAG	
pwer149	AGCGCAACATTCCTCCTCCCTTAC	AGCGCAACATTCCTCCTCCCTTAC	
pwer150	AGCGCAACATTCCGTGTTATGTGG	AGCGCAACATTCCGTGTTATGTGG	
pwer151	AGCGCAACATTCATTAGCAGCGTA	AGCGCAACATTCATTAGCAGCGTA	
pwer152	AGCGCAACATTCCAAGTTTCCGCG	AGCGCAACATTCCAAGTTTCCGCG	
pwer153	AGCGCAACATTCCCTTGTTCACCT	AGCGCAACATTCCCTTGTTCACCT	
pwer154	AGCGCAACATTCAACCAGCAGATT	AGCGCAACATTCAACCAGCAGATT	
pwer155	AGCGCAACATTCCTAGAGCTCCCA	AGCGCAACATTCCTAGAGCTCCCA	
pwer156	AGCGCAACATTCCACGCAGTCTAC	AGCGCAACATTCCACGCAGTCTAC	
pwer157	AGCGCAACATTCACAAACATGGTC	AGCGCAACATTCACAAACATGGTC	
pwer158	AGCGCAACATTCTCGAAACATGCA	AGCGCAACATTCTCGAAACATGCA	
pwer159	AGCGCAACATTCTTCCCACCCATT	AGCGCAACATTCTTCCCACCCATT	
pwer160	AGCGCAACATTCAGCAGAACATCT	AGCGCAACATTCAGCAGAACATCT	
pwer161	AGCGCAACATTCGAAACATCCCAC	AGCGCAACATTCGAAACATCCCAC	
pwer162	AGCGCAACATTCCTGTCAGTGACC	AGCGCAACATTCCTGTCAGTGACC	
pwer163	AGCGCAACATTCACAGCTCAAACA	AGCGCAACATTCACAGCTCAAACA	
pwer164	AGCGCAACATTCTTCTCCATCACA	AGCGCAACATTCTTCTCCATCACA	
pwer165	AGCGCAACATTCATTTAGGACGAC	AGCGCAACATTCATTTAGGACGAC	
pwer166	AGCGCAACATTCGGTTTAACACGC	AGCGCAACATTCGGTTTAACACGC	
pwer167	AGCGCAACATTCAGACAGTAGGAG	AGCGCAACATTCAGACAGTAGGAG	
pwer168	AGCGCAACATTCGCAGATTTCCAG	AGCGCAACATTCGCAGATTTCCAG	
pwer169	AGCGCAACATTCAGATGATCAGTC	AGCGCAACATTCAGATGATCAGTC	
pwer170	AGCGCAACATTCTATCACCGGCAC	AGCGCAACATTCTATCACCGGCAC	
pwer171	AGCGCAACATTCCCAGATATAGCA	AGCGCAACATTCCCAGATATAGCA	
pwer172	CGGTATGAAAGAGCAACACCATCC	CGGTATGAAAGAGCAACACCATCC	
pwer173	CGGTATGAAAGAAGTCGTGCACAT	CGGTATGAAAGAAGTCGTGCACAT	
pwer174	CGGTATGAAAGAAGTTACGAGCTA	CGGTATGAAAGAAGTTACGAGCTA	
pwer175	CGGTATGAAAGATTGCGTTAGCAG	CGGTATGAAAGATTGCGTTAGCAG	
pwer176	CGGTATGAAAGATACGAGCCCTAA	CGGTATGAAAGATACGAGCCCTAA	
pwer177	CGGTATGAAAGATGTCGCAAATAG	CGGTATGAAAGATGTCGCAAATAG	
pwer178	CGGTATGAAAGAACAATAGACACC	CGGTATGAAAGAACAATAGACACC	
pwer179	CGGTATGAAAGATCTCTACCACTC	CGGTATGAAAGATCTCTACCACTC	
pwer180	CGGTATGAAAGACGATCGAACACT	CGGTATGAAAGACGATCGAACACT	
pwer181	CGGTATGAAAGAATTGCAAGCAAC	CGGTATGAAAGAATTGCAAGCAAC	
pwer182	CGGTATGAAAGAAGCGCTCACATC	CGGTATGAAAGAAGCGCTCACATC	
